Group,Red,Yellow,Brown,Green,Blue,Orange,Total
Preston/Daniel/Kevin,7,8,4,8,14,15,56
Group 2 (Willie/Nicole/Shrinivas/Katherine),7,14,9,6,7,9,52
"Group 3 (Alan, Cameron, Sarah, Sen)",10,12,10,4,7,14,57
Group 5,4,6,9,13,10,13,55
Group 8 (3DS),8,12,6,5,10,11,52
Group 13,8,4,8,5,13,16,54
"Chris, Nadav, Nick, Victoria",4,7,9,10,12,11,53
Eater Group,4,8,8,5,13,15,53
Eater Group 2,9,8,7,3,14,10,51
"Jessalyn, Oscar, Michelle, Patrick",9,11,8,2,12,15,57
"Gabby, Kevin ",9,8,11,7,7,14,56